{
  "map": [
    15, 15, 15, 15, 15, 15, 19, 15, 15, 15, 15, 11, 15, 15, 15, 15, 15, 15,
    15, 15, 15, 15, 15,  0,  0,  0,  0,  0,  0,  0,  0, 15, 15, 15, 15, 15,
    15, 15, 15, 15,  0,  0,  0,  0,  0,  0,  0,  0,  0,  0, 15, 15, 15, 15,
    15, 15, 15,  0,  0,  0,  0,  0,  0,  0,  0,  0,  0,  0,  0, 15, 15, 15,
    15, 15, 15,  0,  0,  0,  0,  0,  0,  0,  0,  0,  0,  0,  0, 15, 15, 15,
    15, 15, 15,  0,  0,  0,  0,  0,  0,  0,  0,  0,  0,  0,  0, 15, 15, 15,
    15, 15, 15,  0,  0,  0,  0,  0,  0,  0,  0,  0,  0,  0,  0, 15, 15, 15,
    15, 15, 15,  0,  0,  0,  0,  0,  0,  0,  0,  0,  0,  0,  0, 15, 15, 15,
    15, 15, 15,  0,  0,  0,  0,  0,  0,  0,  0,  0,  0,  0,  0, 15, 15, 15,
     0,  0,  0,  0,  0,  0,  0,  0,  0,  0,  0,  0,  0,  0,  0,  0, 15,  0,
     0,  0,  0,  0,  0,  0,  0,  0,  0,  0,  0,  0,  0,  0,  0,  0,  6,  0,
    15, 15, 15, 15, 15, 15, 15, 15, 15, 15, 15, 15, 15, 15, 15, 15, 15, 15
  ],
  "links": [
    [11, 196]
  ],
  "hasElevator": true,
  "message": ""
}
