{
  "map": [
    15, 31, 31, 31, 31, 31, 31, 31, 31, 31, 31, 31, 31, 15, 31, 15, 15, 15,
    30,  0,  0,  0,  0,  0,  0,  0,  0,  0,  0,  0,  0, 21,  0,  0,  0, 15,
    30,  0,  0,  0,  0,  0,  0,  0,  0,  0,  0,  0,  0, 21,  0,  0,  0, 15,
    30,  0,  0,  0,  0,  0,  0,  0,  0,  0,  0,  0,  0, 21,  0,  0,  0, 15,
    33,  0,  0,  0,  0,  0,  0,  0,  0,  0,  0,  0,  0, 21,  0,  0,  0, 15,
     0,  0,  0,  0,  0,  0,  0,  0,  0,  0,  0,  0,  0, 21, 15,  7, 15, 15,
     0,  0,  0,  0,  0,  0,  0,  0,  0,  0,  0,  0,  0, 21,  0,  0,  0, 15,
    15,  5, 15,  7, 15,  5, 22, 22, 22, 15, 22, 22, 22, 15,  0,  0,  0, 15,
    15,  0,  0,  0,  0,  0,  0,  0,  0,  8,  0,  0,  0,  0,  0,  0,  0, 15,
    15,  0,  0,  0,  0,  0,  0,  0,  0,  0,  0,  0,  0,  0,  0,  0,  0,  0,
    15,  0,  0,  0,  0,  0,  0,  0,  0,  0,  0,  0,  0,  0,  0,  0,  0,  0,
    15, 29, 29, 15, 15, 29, 29, 29, 29, 15, 15, 29, 29, 29, 29, 15, 15, 29
  ],
  "links": [

  ],
  "hasElevator": true,
  "message": ""
}
