{
  "map": [
    15, 15, 15, 15, 15, 15, 15, 15, 15, 15, 15, 15, 15, 15, 15, 15, 15, 15,
    15,  0,  0,  0,  0,  0,  0,  0,  0,  8,  0,  0,  0,  0,  0,  0,  0, 15,
    15,  0,  0,  0,  0,  0,  0,  0,  0,  0,  0,  0,  0,  0,  0,  0,  0, 15,
    15,  0,  0,  0,  0,  0,  0,  0,  0,  0,  0,  0,  0,  0,  0,  0,  0, 15,
     0,  0,  0,  0,  0,  0,  0,  0,  0,  0,  0,  0,  0,  0,  0,  0,  0, 15,
     0,  0,  0,  0,  0,  0,  0,  0,  0,  0,  0,  0,  0,  0,  0,  0,  0,  6,
    15, 15,  0,  0,  0,  0,  0,  0,  0,  0,  0,  0,  0,  0,  0, 15, 15, 15,
    15,  0,  0,  0,  0,  0,  0,  0, 15, 15,  0,  0,  0,  0,  0,  0,  0, 15,
    15,  0,  0,  0,  0,  0,  0,  0, 15, 15,  0,  0,  0,  0,  0,  0,  0, 15,
    15,  5, 15,  0,  0,  0,  0,  0, 15, 15,  0,  0,  0,  0,  0, 15, 15, 15,
    15, 15, 15,  0,  0,  0,  0,  0, 15, 15,  0,  0,  0,  0,  0, 15, 15, 15,
    15, 15, 15,  1,  2,  1,  2,  1, 15, 15,  2,  1,  2,  1,  2, 15, 15, 15
  ],
  "links": [
    [163, 107]
  ],
  "hasElevator": true,
  "message": ""
}
