{
  "map": [
    15, 15, 15, 15, 15, 15, 15, 15, 15, 15, 15, 15, 15, 15, 15, 15, 15, 15,
     0,  0,  0,  0,  0,  0,  0, 15, 15, 15, 15, 15, 15, 15, 15, 15, 15, 15,
     0,  0,  0,  0,  0,  0,  0, 34, 31, 31, 31, 31,  8, 34, 31, 31, 31, 15,
    15, 15, 15,  0,  0,  0,  0,  0,  0,  0,  0,  0,  0,  0,  0,  0,  0, 15,
    15, 15, 15,  0,  0,  0,  0,  0,  0,  0,  0,  0,  0,  0,  0,  0,  0, 15,
    15, 15, 15,  0,  0,  0,  0,  0,  0,  0,  0,  0,  0,  0,  0,  0,  0, 15,
    15, 15, 15,  0,  0,  0,  0,  0,  0,  0,  0, 15, 15,  0,  0,  0,  0, 15,
    15, 15, 15,  0,  0,  0,  0,  0,  2,  1,  2, 15, 15,  1,  2,  1,  2, 15,
    15, 15, 15,  0,  0,  0,  0,  0, 15, 15, 15, 15, 15, 15, 15, 15, 15, 15,
    15, 15, 15,  0,  0,  0,  0,  0,  0,  0,  0,  0,  0,  0,  0,  0,  0, 15,
    15, 15, 15,  0,  0,  0,  0,  0,  0,  0,  0,  0,  0,  0,  0,  0,  0,  6,
    15, 15, 15, 15,  5, 15, 15, 15, 15, 15, 15, 15, 15, 15, 15, 15, 15, 15
  ],
  "links": [
    [202, 197]
  ],
  "hasElevator": true,
  "message": ""
}
