{
  "map": [
    15, 15, 15, 15, 15, 15, 15, 15, 15, 15, 15, 15, 15, 15, 15, 15, 15, 15,
    15,  0,  8,  0,  0,  0, 21,  0,  0,  0,  0,  0,  0, 21,  0,  0,  0, 15,
    15,  0,  0,  0,  0,  0, 21,  0,  0,  0,  0,  0,  0, 21,  0,  0,  0, 15,
    15, 15, 15,  0,  0,  0, 21,  0,  0,  0,  0,  0,  0, 15,  4,  3,  4, 15,
    15,  0,  0,  0,  0,  0, 21,  0,  0,  0,  0,  0,  0, 15,  0,  0,  0, 15,
    15,  0,  0,  0,  0,  0, 21,  0,  0,  0,  0,  0,  0, 15,  0,  0,  0, 15,
    15, 15, 22, 22, 22, 15, 15, 15, 15,  0,  0,  0,  0, 15,  5, 15, 15, 15,
    15,  0,  0,  0,  0,  0,  0,  0, 15,  0,  0,  0,  0,  0,  0,  0,  0, 15,
    15,  0,  0,  0,  0,  0,  0,  0, 15,  0,  0,  0,  0,  0,  0,  0,  0, 15,
     0,  0,  0,  0,  0,  0,  0,  0, 15,  0,  0,  0,  0,  0,  0,  0,  0, 15,
     0,  0,  0,  0,  0,  0,  0,  0, 15,  0,  0,  0,  0,  0,  0,  0,  0,  6,
    15, 15, 15, 15, 15, 15, 15, 15, 15, 15, 15, 15, 15, 15, 15, 15, 15, 15
  ],
  "links": [
    [122, 197]
  ],
  "hasElevator": true,
  "message": ""
}
