{
  "map": [
    15, 15, 15, 15, 31, 31, 31, 31, 31, 31, 15, 31, 31, 31, 31, 31, 31, 15,
    15,  0,  0,  0,  0,  0,  0,  0,  0,  0, 15,  0,  0,  0,  0,  0,  0, 32,
    15,  0,  0,  0,  0,  0,  0,  0,  0,  0, 15,  0,  0,  0,  0,  0,  0, 34,
    15,  0,  0,  0,  0,  0,  0,  0,  0,  0, 15,  0,  0,  0,  0,  0,  0,  0,
    15,  0,  0,  0,  0,  0,  0,  0,  0,  0,  0,  0,  0,  0,  0,  0,  0,  0,
    15,  0,  0,  0, 15, 15, 15, 15,  0,  0,  0,  0,  0, 35, 29, 29, 29, 29,
    15,  0,  0,  0, 15, 15, 15, 15,  0,  0,  0,  0,  0, 32, 15, 15, 15, 15,
    15,  0,  0,  0, 15, 15, 15, 15,  0,  0,  0,  0,  0, 32, 15, 15, 15, 15,
    15,  0,  0,  0, 15, 15, 15, 15,  0,  0,  0,  0,  0, 32, 15, 15, 15, 15,
     0,  0,  0,  0,  0,  0,  0,  0,  0,  0,  0,  0,  0, 32, 15, 15, 15, 15,
     0,  0,  0,  0,  0,  0,  0,  0,  0,  0,  0,  0,  0, 32, 15, 15, 15, 15,
    15, 15, 15, 15, 15, 15, 15, 15, 15, 15, 29, 15, 15, 15, 15, 15, 15, 15
  ],
  "links": [

  ],
  "hasElevator": true,
  "message": ""
}
