{
  "map": [
    15, 15, 15, 15, 15, 15, 15, 31, 31, 31, 15, 15, 15, 15, 15, 15, 15, 15,
    15,  0,  0,  0,  0, 34, 33,  0,  0,  0, 34, 30,  0, 16,  0,  0, 32, 15,
     0,  0,  0,  0,  0,  0,  0,  0,  0,  0,  0, 32, 29, 31, 16, 16, 15, 15,
     0,  0,  0,  0,  0,  0,  0,  0,  0,  0,  0, 32, 33,  0,  0,  0, 34, 15,
    15,  0,  0,  0,  0,  0,  0,  0,  0,  0,  0, 16,  0,  0,  0,  0,  0, 32,
    15,  0,  0,  0,  0,  0,  0,  0,  0,  0,  0,  0,  0,  0,  0,  0,  0, 32,
    15,  0,  0,  0,  0,  0,  0,  0,  2,  0,  0,  0,  0,  0, 16,  0,  0, 32,
    15,  0,  0,  0,  0,  0,  0,  0, 15,  0,  0,  0,  0,  0, 16,  0,  0, 15,
    15,  0,  0,  0,  0,  0,  0,  0, 15,  0,  0,  0,  0,  0, 16,  0,  0, 15,
    15,  0, 15, 15,  0,  0, 15, 15, 15,  0,  0,  0,  0,  0, 16,  0,  0,  0,
    15,  0, 32, 30,  0,  0,  0,  0, 16,  0,  0,  0, 15, 15, 15,  0,  0,  0,
    15,  1, 32, 30,  2,  1,  2,  1, 16,  1,  2,  1, 15, 15, 15, 15, 15, 15
  ],
  "links": [

  ],
  "hasElevator": false,
  "message": ""
}
