{
  "map": [
    15, 15, 15, 15, 15, 15, 15, 15, 15, 15, 15, 15, 15, 15, 15, 15, 15, 15,
    15,  0,  0,  0,  0, 15, 15, 15, 15, 15, 15,  0,  0,  0,  0,  0,  0, 15,
     0,  0,  0,  0,  0, 15, 15, 15, 15, 15, 15,  0,  0,  0,  0,  0,  0,  0,
     0,  0,  0,  0,  0, 15, 15, 15, 15, 15, 15,  0,  0,  0,  0,  0,  0,  0,
    15, 15, 15,  0,  0, 15, 15, 15, 15, 15, 15,  0,  0, 15, 15, 15, 15, 15,
    15,  0,  0,  0,  0, 15, 15, 15, 15, 15, 15,  0,  0, 15, 15, 15, 15, 15,
    15,  0,  0,  0,  0, 15, 15, 15, 15, 15, 15, 14, 14, 15, 15, 15, 15, 15,
    15,  0,  0,  0,  0, 15, 15, 15, 15, 15, 15,  0,  0, 15, 31, 15, 31, 15,
    15,  0,  0,  0,  0, 15, 15, 15, 15, 15, 15,  0,  0, 15,  0,  8,  0, 15,
    15,  0,  0,  0,  0,  0, 15,  0,  0,  0,  0,  0,  0, 21,  0,  0,  0, 15,
    15,  0,  0,  0,  0,  0,  6,  0,  0,  0,  0,  0,  0, 21,  0,  0,  0, 15,
    15,  5, 15, 15, 15, 29, 29, 29, 29, 29, 29, 15, 15, 15, 15, 15, 15, 15
  ],
  "links": [

  ],
  "hasElevator": true,
  "message": ""
}
