{
  "map": [
    15, 15, 15, 15, 15, 15, 15, 15, 15, 15, 15, 15, 15, 15, 15, 15, 15, 15,
    15, 15, 15, 15, 15, 15, 15, 15,  0,  0,  0,  0,  0,  0,  0,  0,  0, 15,
    15, 15, 15, 15, 15, 15, 15, 15,  0,  0,  0,  0,  0,  0,  0,  0,  0, 15,
    15, 15, 15, 15, 15, 15, 15, 15,  0,  0,  0,  0,  0,  0,  0,  0,  0,  0,
    15, 15, 15, 15, 15, 15, 15, 15,  0,  0,  0,  0,  0,  0,  0,  0,  0,  0,
    15, 15, 15, 15, 15, 15, 15, 15, 15, 15,  7, 15, 15, 15, 15, 15, 15, 15,
    15, 15, 15, 15, 15, 15, 15, 15,  0,  0,  0,  0,  0, 15, 15, 15, 15, 15,
    15, 15, 15, 15, 15, 15, 15, 15,  0,  0,  0,  0,  0, 15, 15, 15, 15, 15,
    15,  0,  0,  0,  0, 15,  0,  0,  0,  0,  0,  0,  0, 15, 15, 15, 15, 15,
     0,  0,  0,  0,  0, 15,  0,  0,  0,  0,  0,  0,  0, 15, 15, 15, 15, 15,
     0,  0,  0,  0,  0,  6,  0,  0,  0,  0,  0,  0,  0, 15, 15, 15, 15, 15,
    15, 15,  5, 15, 15, 15, 15, 15, 15, 15,  5, 15, 15, 15, 15, 15, 15, 15
  ],
  "links": [
    [200, 185],
    [208, 100]
  ],
  "hasElevator": true,
  "message": ""
}
