{
  "map": [
    15, 15, 15, 19, 15, 15, 15, 15, 15, 15, 15, 15, 15, 15, 15, 15, 15, 15,
    15,  0,  0,  0,  0,  0, 15,  0,  0,  0,  0,  0,  0,  0,  0,  0,  0, 15,
    15,  0,  0,  0,  0,  0, 15,  0,  0,  0,  0,  0,  0,  0,  0,  0,  0, 15,
    15,  0,  0,  0,  0,  0, 15,  0,  0,  0,  0,  0,  0,  0,  0,  0,  0, 15,
    15,  0,  0,  0,  0,  0, 15, 15, 15, 15, 15, 15, 15, 15, 15, 15, 15, 15,
    15,  0,  0,  0,  0,  0,  0,  0,  0,  0,  0,  0,  0,  0,  0,  0,  0, 15,
    15,  0,  0,  0,  0,  0,  0,  0,  0,  0,  0,  0,  0,  0,  0,  0,  0, 12,
    15,  0,  0,  0,  0,  0,  0,  0,  0,  0,  0,  0,  0,  0,  0,  0,  0, 15,
    15,  0,  0,  0,  0,  0, 15, 15, 15, 15, 15, 15, 15, 15, 15, 15, 15, 15,
     0,  0,  0,  0,  0,  0, 15,  0,  0,  0,  0,  0,  0,  0,  0,  0,  0,  0,
     0,  0,  0,  0,  0,  0,  6,  0,  0,  0,  0,  0,  0,  0,  0,  0,  0,  0,
    15, 15, 15, 15, 15, 15, 15, 15, 15, 15, 15, 15, 15, 15, 15, 15, 15, 15
  ],
  "links": [

  ],
  "hasElevator": true,
  "message": ""
}
