{
  "map": [
    15, 15, 15, 31, 31, 31, 31, 31, 31, 31, 31, 31, 31, 31, 31, 31, 31, 31,
    15, 15, 33,  0,  0,  0,  0,  0,  0, 13, 13,  0,  0,  0,  0,  0,  0,  0,
    15, 30,  0,  0,  0,  0,  0,  0,  0, 16, 36,  0,  0,  0,  0,  0,  0,  0,
    15, 33,  0,  0,  0,  0,  0,  0,  0,  0, 16,  0,  0,  0,  0,  0, 29, 29,
    30,  0,  0,  0,  0,  0,  0,  0,  0,  0,  0,  0,  0,  0,  0, 35, 15, 15,
    30,  0,  0,  0,  0,  0, 16,  0,  0,  0,  0,  0,  0,  0,  0, 34, 15, 15,
    30,  0,  0,  0,  0,  0, 32, 36,  0,  0,  0,  0,  0,  0,  0,  0, 32, 15,
    33,  0,  0,  0,  0,  0, 32, 33,  0,  0,  0,  0,  0,  0,  0,  0, 32, 15,
     0,  0,  0,  0,  0,  0, 16,  0,  0,  0,  0,  0,  0,  0,  0,  0, 32, 15,
     0,  0,  0,  0,  0,  0, 16,  0,  0,  0,  0,  0,  0,  0,  0, 35, 15, 15,
    15, 15, 15,  0,  0,  0, 32, 36,  0,  0,  0,  0,  0,  0,  0, 32, 15, 15,
    15, 15, 15, 15, 15, 15, 15, 15,  2,  1,  2,  1,  2, 15, 15, 15, 15, 15
  ],
  "links": [

  ],
  "hasElevator": false,
  "message": ""
}
