{
  "map": [
    15, 15, 15, 15, 15, 15, 15, 15, 15, 15, 15, 15, 15, 15, 15, 15, 15, 15,
    15,  0,  0,  0,  0,  8,  0,  0, 15, 15,  0,  0,  0,  0,  0,  0,  0, 15,
    15,  0,  0,  0,  0,  0,  0,  0, 15, 15,  0,  0,  0,  0,  0,  0,  0, 15,
    15,  0,  0,  0,  0,  0,  0,  0, 15, 15,  0,  0,  0,  0,  0,  0,  0, 15,
    15,  0,  0,  0,  0,  0,  0,  0,  6,  6,  0,  0,  0,  0,  0,  0,  0, 15,
    15,  5, 15,  5,  0,  0,  0,  0, 15, 15,  0,  0,  0,  0, 15,  5, 15, 15,
    15,  0,  0,  0,  0,  0,  0, 15, 15, 15, 15,  0,  0,  0,  0,  0,  0, 15,
     0,  0,  0,  0,  0,  0,  0, 15, 15, 15, 15,  0,  0,  0,  0,  0,  0, 15,
     0,  0,  0,  0,  0,  0,  0, 15, 15, 15, 15,  0,  0,  0,  0,  0,  0,  6,
    15, 15,  0,  0,  0,  0,  0, 15, 15, 15, 15,  0,  0,  0,  0,  0, 15, 15,
    15, 15, 15,  0,  0,  0,  0, 15, 15, 15, 15,  0,  0,  0,  0, 15, 15, 15,
    15, 15, 15, 15, 15, 15, 15, 15, 15, 15, 15, 15, 15, 15, 15, 15, 15, 15
  ],
  "links": [
    [91, 80],
    [93, 81],
    [105, 161]
  ],
  "hasElevator": true,
  "message": ""
}
