{
  "map": [
    15, 15, 15, 15, 15, 15, 15, 15, 15, 15, 15, 15, 15, 15, 15, 15, 15, 15,
    15,  0,  0,  0,  0,  0,  0,  0,  0, 15,  0,  0,  0,  0,  0,  0,  0, 15,
    10,  0,  0,  0,  0,  0,  0,  0,  0,  6,  0,  0,  0,  0,  0,  0,  0, 15,
    15,  0,  0,  0,  0,  0,  0,  0,  0, 15,  0,  0,  0,  0,  0,  0,  0, 15,
    15, 15, 15, 15, 15, 15, 15, 15, 15, 15,  0,  0,  0,  0,  0,  0,  0, 15,
    15,  0,  0,  0,  0, 15,  0,  0,  0,  0,  0,  0,  0,  0,  0,  0,  0, 15,
    18,  0,  0,  0,  0, 15,  0,  0,  0,  0,  0,  0,  0,  0,  0,  0,  0, 15,
    15,  0,  0,  0,  0, 15,  0,  0,  0,  0,  0,  0,  0,  0,  0,  0,  0, 15,
    15,  0,  0,  0,  0,  0,  0,  0,  0,  0,  0,  0,  0, 15, 15,  5, 15, 15,
     0,  0,  0,  0,  0,  0,  0,  0,  0,  0,  0,  0,  0, 15,  0,  0,  0,  0,
     0,  0,  0,  0,  0,  0,  0,  0,  0,  0,  0,  0,  0,  6,  0,  0,  0,  0,
    15, 15, 15, 15, 15, 15, 15, 15, 15, 15, 15, 15, 15, 15, 15, 15, 15, 15
  ],
  "links": [
    [36, 193]
  ],
  "hasElevator": true,
  "message": ""
}
