{
  "map": [
    15, 15, 15, 15, 15, 15, 15, 15, 15, 15, 15, 15, 15, 15, 15, 15, 15, 15,
    15,  0,  8,  0,  0,  0,  0, 15,  0,  0,  0,  0, 15, 15, 15, 15, 15, 15,
    15,  0,  0,  0,  0,  0,  0, 15,  0,  0,  0,  0, 15, 15, 15, 15, 15, 15,
     0,  0,  0,  0,  0,  0,  0, 15,  0,  0,  0,  0, 15, 15, 15, 15, 15, 15,
     0,  0,  0,  0,  0,  0,  0,  6,  0,  0,  0,  0, 15,  0,  0,  0,  0, 15,
    15, 15, 15, 15, 15,  5, 15, 15,  0,  0,  0,  0, 15,  0,  0,  0,  0, 15,
    15,  0,  0,  0,  0,  0,  0, 15,  0,  0,  0,  0, 15,  0,  0,  0,  0, 15,
    15,  0,  0,  0,  0,  0,  0, 15,  0,  0,  0,  0,  6,  0,  0,  0,  0, 15,
    15,  0,  0,  0,  0,  0,  0, 15, 15, 15,  5, 15, 15,  0,  0,  0,  0, 15,
    15,  0,  0,  0,  0,  0,  0,  0,  0,  0,  0,  0, 15,  0,  0,  0,  0, 15,
    15,  0,  0,  0,  0,  0,  0,  0,  0,  0,  0,  0, 15,  0,  0,  0,  0,  6,
    15, 15, 15, 15, 15, 15, 15, 15, 15, 15, 15, 15, 15, 15, 15,  5, 15, 15
  ],
  "links": [
    [95, 79],
    [154, 138],
    [213, 197]
  ],
  "hasElevator": true,
  "message": ""
}
